24 30
1 1 1 1 1 1 1 1 1 1 1 1 1 1 1 1 1 1 1 1 1 1 1 1
1 1 1 1 1 1 1 1 1 1 1 1 1 1 1 1 1 1 1 1 1 1 1 1
1 1 1 1 1 1 1 1 1 1 1 1 1 1 1 1 1 1 1 1 1 1 1 1
1 1 1 1 1 1 1 1 1 1 1 1 1 1 1 1 1 1 1 1 1 1 1 1
1 1 1 1 1 1 1 1 1 1 1 1 1 1 1 1 1 1 1 1 1 1 1 1
1 1 1 1 1 1 1 1 1 1 1 1 1 1 1 1 1 1 1 1 1 1 1 1
1 1 1 1 3 1 1 1 1 1 1 1 1 1 1 1 1 1 1 1 1 1 1 1
1 1 1 1 1 1 1 1 1 1 1 1 1 1 1 1 1 1 1 1 3 1 1 1
1 1 1 1 1 1 1 1 3 1 1 1 1 1 3 1 1 1 1 1 1 1 1 1
1 1 1 1 1 1 1 1 1 1 1 1 1 1 1 1 1 1 1 1 1 1 1 1
1 1 1 1 1 1 1 1 1 1 1 1 1 3 1 1 1 1 1 3 1 1 1 1
1 1 1 1 3 1 1 1 1 1 1 1 1 1 1 1 1 1 1 1 1 1 1 1
1 1 1 1 1 1 1 1 1 1 3 1 1 1 1 1 1 1 1 1 1 1 1 1
1 1 1 1 1 1 1 1 1 1 1 1 1 19 19 19 19 19 19 19 19 19 19 19
1 1 1 3 1 1 3 1 1 1 1 1 19 19 19 19 19 19 19 19 19 19 19 19
1 1 1 1 1 1 1 1 1 1 1 19 19 19 19 19 19 19 19 19 19 19 19 19
1 1 1 1 1 1 1 1 17 18 19 19 19 19 1 1 1 1 1 1 1 1 1 1
1 1 1 1 1 1 1 1 17 18 19 19 19 19 1 1 1 1 1 3 1 1 1 1
1 1 1 1 1 1 1 1 18 18 17 19 19 1 1 1 1 1 1 1 1 1 1 1
1 1 1 1 3 1 1 1 18 18 17 1 1 1 1 1 1 1 1 1 1 1 1 1
1 1 1 1 1 1 1 1 18 18 17 1 1 1 3 1 1 1 1 1 1 1 1 1
1 1 1 1 1 1 1 19 19 18 19 19 1 1 1 1 1 1 1 1 1 1 1 1
1 1 3 1 1 1 19 19 19 19 19 1 1 1 1 1 1 1 1 1 3 1 1 1
1 1 3 19 19 19 19 19 18 18 18 3 1 1 1 1 1 1 1 1 1 1 1 1
19 19 19 19 19 19 19 19 17 17 17 1 1 1 1 1 3 1 1 1 1 1 1 1
19 19 19 19 19 19 19 19 17 19 17 1 1 1 1 1 1 1 1 1 1 1 1 1
19 19 19 19 19 19 19 19 19 19 1 1 1 1 1 1 1 1 1 1 1 1 1 1
1 1 1 1 1 1 1 1 1 1 1 1 1 1 1 1 1 1 1 1 1 1 1 1
1 3 3 1 1 1 1 1 1 1 1 1 3 1 1 1 1 1 3 1 1 1 1 1
1 1 1 1 1 1 1 1 1 1 1 1 1 1 1 1 1 1 1 1 1 1 1 1