24 30
1 1 1 1 1 1 1 1 1 1 1 1 1 1 1 1 1 1 1 1 1 1 1 1
1 1 1 1 1 1 1 1 1 3 1 1 1 3 1 1 1 3 1 1 1 1 1 1
1 1 1 1 1 1 3 1 1 1 1 1 1 1 1 1 1 1 1 1 1 1 1 1
1 1 1 3 1 1 1 1 1 1 3 1 1 1 1 1 1 1 1 1 1 1 1 1
1 1 1 1 1 1 1 1 1 3 1 1 1 1 3 1 1 1 1 1 19 19 19 1
1 1 1 1 1 3 1 1 1 1 1 1 3 1 1 1 3 1 19 19 19 19 1 1
1 1 1 1 1 1 1 1 1 1 1 1 1 3 1 1 1 19 19 19 19 19 1 1
1 1 3 1 1 3 1 1 3 1 1 1 1 1 1 19 19 19 19 19 19 19 1 1
1 1 1 1 1 1 1 1 1 1 1 1 1 1 19 17 17 19 19 19 19 19 1 1
1 1 1 1 1 1 1 1 1 1 1 1 1 1 17 17 17 17 19 19 19 19 1 1
1 1 1 3 1 1 1 20 1 3 1 1 1 17 17 17 17 17 19 19 19 19 1 1
1 1 3 1 1 20 20 20 20 1 1 1 17 17 17 17 17 17 19 19 19 19 1 1
1 1 1 1 1 20 20 20 20 1 1 1 17 17 17 17 1 1 19 19 19 19 1 1
1 1 1 1 1 20 20 20 1 1 1 17 17 17 17 1 1 1 19 19 19 19 1 1
1 1 1 1 1 1 1 1 3 1 17 17 17 17 1 1 1 3 19 19 19 19 1 1
1 1 1 3 1 1 1 1 1 17 17 17 17 17 1 1 1 1 19 19 19 19 1 1
1 1 1 3 1 1 1 1 17 17 17 17 17 1 1 1 1 1 19 19 19 19 1 1
1 1 1 1 1 1 1 17 17 17 17 17 17 1 1 1 1 1 19 19 19 19 1 1
1 1 1 1 1 1 1 17 17 17 17 17 17 1 3 1 1 1 19 19 19 19 1 1
1 1 1 1 1 1 17 17 17 17 17 17 1 1 1 1 1 1 19 19 19 19 1 1
1 1 1 1 1 17 17 17 17 17 17 17 1 1 1 1 1 1 19 19 19 19 1 1
1 1 1 1 17 17 17 17 17 17 17 1 1 1 3 1 1 1 19 19 19 19 1 1
3 1 1 17 17 17 17 17 17 17 1 1 1 1 1 1 1 1 19 19 19 19 1 1
1 1 17 17 17 17 17 17 1 1 1 1 1 3 1 1 1 3 19 19 19 19 3 1
19 17 17 19 19 19 1 1 1 3 1 1 1 1 1 1 1 1 19 19 19 19 1 1
19 19 19 19 19 1 1 1 1 1 1 1 1 1 1 1 1 1 19 19 19 19 1 1
19 19 19 19 19 1 1 1 1 1 1 1 1 1 1 1 1 3 19 19 19 19 1 1
19 19 19 19 3 1 1 1 1 1 1 1 1 3 1 1 1 1 19 19 19 19 1 1
19 19 19 19 1 1 1 1 1 1 1 1 1 1 1 1 1 1 19 19 19 19 1 1
19 19 19 19 1 1 1 1 1 1 1 1 1 1 1 1 1 3 18 18 18 18 1 1