40 30
0 0 0 0 0 0 0 0 0 0 0 0 0 0 0 0 0 0 0 0 0 0 0 0 11 -1 -1 -1 -1 -1 -1 -1 -1 -1 -1 -1 -1 -1 -1 -1
0 13 0 0 0 0 0 0 0 2 0 0 0 2 0 0 0 2 0 0 0 0 0 0 11 -1 -1 -1 -1 -1 -1 -1 -1 -1 -1 -1 -1 -1 -1 -1
0 0 0 0 0 0 2 0 0 0 0 0 0 0 0 0 0 8 0 0 0 0 1 1 11 -1 -1 -1 -1 -1 -1 -1 -1 -1 -1 -1 -1 -1 -1 -1
0 0 0 2 11 11 11 12 0 0 2 0 0 0 0 0 7 5 6 0 0 1 1 1 11 -1 -1 -1 -1 -1 -1 -1 -1 -1 -1 -1 -1 -1 -1 -1
0 0 11 11 11 11 13 11 11 11 0 0 0 0 0 0 10 4 9 0 1 1 1 1 11 -1 -1 -1 -1 -1 -1 -1 -1 -1 -1 -1 -1 -1 -1 -1
0 0 11 11 11 11 11 11 11 11 0 0 0 0 0 0 2 3 1 1 1 1 1 1 11 -1 -1 -1 -1 -1 -1 -1 -1 -1 -1 -1 -1 -1 -1 -1
0 0 11 11 12 11 11 11 11 0 0 0 0 2 0 0 0 1 1 1 1 1 1 1 11 -1 -1 -1 -1 -1 -1 -1 -1 -1 -1 -1 -1 -1 -1 -1
0 0 2 0 0 11 11 11 0 0 0 2 0 0 0 1 1 1 1 1 1 1 1 1 11 -1 -1 -1 -1 -1 -1 -1 -1 -1 -1 -1 -1 -1 -1 -1
0 0 2 0 0 0 11 0 0 0 0 0 0 0 1 1 1 1 1 1 1 1 1 0 11 -1 -1 -1 -1 -1 -1 -1 -1 -1 -1 -1 -1 -1 -1 -1
0 0 0 0 0 0 0 0 0 0 0 0 0 0 1 1 1 1 1 1 1 1 0 0 11 -1 -1 -1 -1 -1 -1 -1 -1 -1 -1 -1 -1 -1 -1 -1
0 0 0 2 0 0 0 0 0 0 0 0 0 1 1 1 1 1 1 1 1 1 0 0 11 -1 -1 -1 -1 -1 -1 -1 -1 -1 -1 -1 -1 -1 -1 -1
0 0 2 0 0 0 0 0 2 0 0 0 0 1 1 1 1 1 1 1 1 1 0 0 11 -1 -1 -1 -1 -1 -1 -1 -1 -1 -1 -1 -1 -1 -1 -1
0 0 0 0 0 0 0 0 8 0 0 0 1 1 1 1 1 0 1 1 1 1 0 0 11 -1 -1 -1 -1 -1 -1 -1 -1 -1 -1 -1 -1 -1 -1 -1
0 0 0 0 0 0 0 7 5 6 0 1 1 1 1 1 0 0 1 1 1 1 0 0 11 -1 -1 -1 -1 -1 -1 -1 -1 -1 -1 -1 -1 -1 -1 -1
0 0 0 0 0 0 0 10 4 9 1 1 1 1 1 0 0 2 1 1 1 1 0 0 11 -1 -1 -1 -1 -1 -1 -1 -1 -1 -1 -1 -1 -1 -1 -1
0 0 0 2 0 0 0 0 3 1 1 1 1 1 0 0 0 0 1 1 1 1 0 0 11 -1 -1 -1 -1 -1 -1 -1 -1 -1 -1 -1 -1 -1 -1 -1
0 0 0 2 0 0 0 0 1 1 1 1 1 1 0 0 0 0 1 1 1 1 0 0 11 -1 -1 -1 -1 -1 -1 -1 -1 -1 -1 -1 -1 -1 -1 -1
0 0 0 0 0 0 0 1 1 1 1 1 1 0 0 0 0 0 1 1 1 1 0 0 11 -1 -1 -1 -1 -1 -1 -1 -1 -1 -1 -1 -1 -1 -1 -1
0 0 0 0 0 0 0 1 1 1 1 1 1 0 0 0 0 0 1 1 1 1 0 0 11 -1 -1 -1 -1 -1 -1 -1 -1 -1 -1 -1 -1 -1 -1 -1
0 0 0 8 0 0 1 1 1 1 1 1 0 0 8 0 0 0 1 1 1 1 0 0 11 -1 -1 -1 -1 -1 -1 -1 -1 -1 -1 -1 -1 -1 -1 -1
0 0 7 5 6 1 1 1 1 1 1 1 0 7 5 6 0 0 1 1 1 1 0 0 11 -1 -1 -1 -1 -1 -1 -1 -1 -1 -1 -1 -1 -1 -1 -1
0 0 10 4 9 1 1 1 1 1 1 0 0 10 4 9 0 0 1 1 1 1 0 0 11 -1 -1 -1 -1 -1 11 11 11 11 11 -1 -1 -1 -1 -1
0 0 0 3 1 1 1 1 1 1 0 0 0 0 3 0 0 0 1 1 1 1 0 0 11 -1 -1 -1 -1 -1 11 1 1 1 11 -1 -1 -1 -1 -1
0 0 1 1 1 1 1 1 0 0 0 0 0 2 0 0 0 2 1 1 1 1 2 0 11 -1 -1 -1 -1 -1 11 1 2 1 11 -1 -1 -1 -1 -1
1 1 1 1 1 1 0 0 0 2 0 0 0 0 0 0 0 0 1 1 1 1 2 0 11 -1 -1 -1 -1 -1 11 1 1 1 11 -1 -1 -1 -1 -1
1 1 1 1 1 0 0 0 0 0 0 0 0 0 0 0 0 0 1 1 1 1 0 0 11 -1 -1 -1 -1 -1 11 11 13 11 11 -1 -1 -1 -1 -1
1 1 1 1 1 0 0 0 0 0 0 0 0 0 0 0 0 2 1 1 1 1 0 0 11 -1 -1 -1 -1 -1 -1 -1 -1 -1 -1 -1 -1 -1 -1 -1
1 1 1 1 2 0 0 0 0 0 0 0 0 2 0 0 0 0 1 1 1 1 0 0 11 -1 -1 -1 -1 -1 -1 -1 -1 -1 -1 -1 -1 -1 -1 -1
1 1 1 1 2 0 0 2 0 0 0 0 0 0 0 0 0 0 1 1 1 1 0 0 11 -1 -1 -1 -1 -1 -1 -1 -1 -1 -1 -1 -1 -1 -1 -1
1 1 1 1 0 0 0 0 0 0 0 0 0 0 0 0 0 2 1 1 1 1 0 0 11 -1 -1 -1 -1 -1 -1 -1 -1 -1 -1 -1 -1 -1 -1 -1