130 62
5 0 0 50 2 44 5 58 33 58 34 34 34 34 34 58 33 58 34 34 34 34 34 58 33 58 34 34 34 34 34 58 33 58 32 39 81 79 79 79 79 79 79 79 79 79 79 79 79 79 79 79 79 79 79 79 79 79 79 79 79 79 79 79 79 79 79 79 79 79 79 79 79 79 79 84 79 79 79 79 79 79 79 79 79 84 79 79 79 79 79 79 79 79 90 79 79 79 79 79 79 79 79 79 79 79 79 -1 -1 -1 -1 -1 -1 -1 -1 -1 -1 -1 -1 -1 -1 -1 -1 -1 -1 -1 -1 -1 -1 -1
4 27 3 50 2 2 4 58 60 58 34 34 34 34 34 58 60 58 34 34 34 34 34 58 60 58 34 34 34 34 34 58 60 58 32 32 32 81 79 79 79 79 79 79 79 79 79 79 79 79 79 79 79 79 79 79 79 79 79 79 79 79 79 79 79 79 79 79 79 79 79 79 79 79 79 84 79 79 79 79 79 79 79 79 79 84 79 79 79 79 79 79 79 79 90 79 79 79 79 79 79 79 79 79 79 79 79 -1 -1 -1 -1 -1 -1 -1 -1 -1 -1 -1 -1 -1 -1 -1 -1 -1 -1 -1 -1 -1 -1 -1
1 0 97 50 2 264 59 58 66 58 32 32 32 32 32 58 66 58 32 32 32 32 32 58 66 58 32 32 32 32 32 58 66 58 88 89 85 67 83 83 83 83 83 83 83 79 79 79 79 79 79 79 79 79 79 79 79 79 79 79 79 79 79 79 79 79 79 79 79 79 79 79 79 79 79 84 79 79 79 79 79 79 79 79 79 84 79 79 79 79 79 79 79 79 90 79 79 79 79 79 79 79 79 79 79 79 79 -1 -1 -1 -1 -1 -1 -1 -1 -1 -1 -1 -1 -1 -1 -1 -1 -1 -1 -1 -1 -1 -1 -1
51 51 51 2 2 2 2 126 29 125 2 2 2 2 2 126 29 125 2 2 2 2 2 126 29 125 2 2 2 2 2 126 29 125 2 2 2 2 67 60 58 67 67 67 67 81 79 79 79 79 79 79 79 79 79 79 79 79 79 79 79 79 79 79 79 79 79 79 79 79 79 79 79 79 79 84 79 79 79 79 79 79 79 79 79 84 79 79 79 79 79 79 79 79 90 79 79 79 79 79 79 79 79 79 79 79 79 -1 -1 -1 -1 -1 -1 -1 -1 -1 -1 -1 -1 -1 -1 -1 -1 -1 -1 -1 -1 -1 -1 -1
2 2 2 2 2 2 2 2 2 2 2 2 2 2 2 2 2 2 2 2 2 2 2 2 2 2 2 2 2 2 2 2 2 2 2 2 2 2 2 2 58 2 2 2 2 2 81 83 83 83 79 79 79 79 79 79 79 79 79 79 79 79 79 79 79 79 79 79 79 79 79 79 79 79 79 84 79 79 79 79 79 79 79 79 79 84 79 79 79 79 79 79 79 79 90 79 79 79 79 79 79 79 79 79 79 79 79 -1 -1 -1 -1 -1 -1 -1 -1 -1 -1 -1 -1 -1 -1 -1 -1 -1 -1 -1 -1 -1 -1 -1
2 2 2 2 2 2 2 2 2 2 2 2 2 2 2 2 2 2 2 2 2 2 2 2 2 2 2 2 2 2 2 2 2 2 2 2 2 2 2 2 58 2 2 2 2 2 2 58 2 2 81 79 79 79 79 79 79 79 79 79 79 79 79 79 79 79 79 79 79 79 79 79 79 79 79 81 83 83 83 83 83 83 83 83 83 84 79 79 79 79 79 79 79 79 90 79 79 79 79 79 79 79 79 79 79 79 79 90 -1 -1 -1 -1 -1 -1 -1 -1 -1 -1 -1 -1 -1 -1 -1 -1 -1 -1 -1 -1 -1 -1
2 2 2 2 2 2 2 2 2 2 2 2 2 2 2 2 2 2 2 2 2 2 2 2 2 2 2 2 2 2 2 2 2 2 2 2 2 2 2 2 65 2 2 2 2 2 2 58 2 2 2 84 79 79 79 79 79 79 79 79 79 79 79 79 79 79 79 79 79 79 79 79 79 79 79 79 58 32 32 32 32 32 32 32 32 84 79 79 79 79 79 79 79 79 90 83 83 83 83 83 83 83 83 83 79 79 79 90 -1 -1 -1 -1 -1 -1 -1 -1 -1 -1 -1 -1 -1 -1 -1 -1 -1 -1 -1 -1 -1 -1
52 52 52 2 2 2 2 2 2 127 2 2 2 52 52 52 52 52 52 52 52 52 52 52 52 52 52 52 52 52 52 52 52 52 52 52 52 52 52 2 64 2 2 2 2 2 85 58 2 2 2 84 79 79 79 79 79 79 79 79 79 79 79 79 79 79 79 83 83 83 83 83 83 83 83 83 58 32 32 34 34 32 32 34 34 84 79 79 79 79 79 79 79 79 90 32 32 32 58 32 32 32 32 58 84 79 79 90 -1 -1 -1 -1 -1 -1 -1 -1 -1 -1 -1 -1 -1 -1 -1 -1 -1 -1 -1 -1 -1 -1
1 22 0 50 2 2 2 2 2 2 2 2 49 0 3 0 0 0 0 0 0 0 1 0 0 0 0 0 0 0 0 0 0 0 0 1 0 0 0 2 63 2 2 2 2 2 2 2 2 256 2 84 79 79 79 79 79 79 79 79 79 79 79 79 79 79 82 99 102 32 32 39 39 39 39 60 58 32 32 122 122 32 32 122 122 84 79 79 79 79 79 79 79 79 90 32 32 32 58 34 34 34 34 58 84 79 79 90 -1 -1 -1 -1 -1 -1 -1 -1 -1 -1 -1 -1 -1 -1 -1 -1 -1 -1 -1 -1 -1 -1
1 0 38 50 2 2 2 52 52 2 2 2 2 56 0 0 1 0 0 0 0 0 0 0 0 3 0 0 0 3 0 0 0 0 0 0 0 55 51 2 63 2 2 2 2 2 2 2 2 257 2 84 79 79 79 79 79 79 79 79 79 79 79 79 79 90 2 104 103 32 66 60 60 66 60 60 58 32 32 34 34 32 32 34 34 84 79 79 79 79 79 79 79 79 90 32 32 32 58 122 122 122 122 58 84 79 79 90 -1 -1 -1 -1 -1 -1 -1 -1 -1 -1 -1 -1 -1 -1 -1 -1 -1 -1 -1 -1 -1 -1
0 3 37 50 2 2 49 3 97 54 52 2 2 2 51 56 0 0 0 0 0 0 0 0 0 0 0 0 0 0 0 0 0 0 0 0 55 2 2 52 62 264 262 262 263 2 2 2 2 2 2 84 79 79 79 79 79 79 79 79 79 79 79 79 79 90 2 2 2 126 29 125 126 29 125 2 58 32 32 122 122 32 32 122 122 84 79 79 79 79 79 79 79 79 90 32 32 33 58 32 32 32 32 58 84 79 79 90 -1 -1 -1 -1 -1 -1 -1 -1 -1 -1 -1 -1 -1 -1 -1 -1 -1 -1 -1 -1 -1 -1
0 0 36 50 2 2 49 0 0 3 0 54 52 2 2 2 51 56 0 3 0 0 0 0 0 0 1 0 0 0 273 0 3 0 0 55 2 2 53 1 61 0 50 2 2 2 2 52 52 52 91 79 79 79 79 79 79 79 79 79 79 79 79 79 79 90 2 2 2 2 2 2 2 2 2 2 58 32 277 32 32 275 32 32 32 84 79 79 79 79 79 79 79 79 90 275 32 32 95 96 97 97 97 97 84 79 79 90 -1 -1 -1 -1 -1 -1 -1 -1 -1 -1 -1 -1 -1 -1 -1 -1 -1 -1 -1 -1 -1 -1
1 0 0 50 2 2 49 273 0 0 0 0 0 54 2 2 2 2 56 0 0 0 0 1 0 0 0 3 0 0 272 0 0 0 55 2 2 53 0 0 61 0 50 2 2 2 49 31 3 3 84 79 79 79 79 79 79 79 79 79 79 79 79 79 79 90 2 2 265 271 271 271 271 266 2 2 2 49 276 97 97 274 97 97 97 84 79 79 79 79 79 79 79 79 90 274 97 97 2 2 2 2 2 2 84 79 79 90 -1 -1 -1 -1 -1 -1 -1 -1 -1 -1 -1 -1 -1 -1 -1 -1 -1 -1 -1 -1 -1 -1
1 0 0 50 2 2 49 272 0 0 0 0 0 0 54 52 2 2 2 56 0 0 0 0 0 0 0 0 0 0 36 0 0 55 2 2 53 0 0 0 3 273 50 2 2 2 49 0 0 97 84 79 79 79 79 79 79 79 79 79 79 79 79 79 79 90 2 2 269 96 96 98 96 270 2 2 2 49 1 0 97 97 97 97 97 84 79 79 79 79 79 79 79 79 90 97 2 2 2 88 89 42 2 256 84 79 79 90 -1 -1 -1 -1 -1 -1 -1 -1 -1 -1 -1 -1 -1 -1 -1 -1 -1 -1 -1 -1 -1 -1
0 0 0 50 2 2 49 36 0 0 0 1 0 0 1 0 54 52 2 2 56 0 0 0 0 1 0 0 0 0 0 0 55 2 2 53 0 1 0 0 0 272 50 2 2 2 49 0 0 91 79 79 79 79 79 79 79 79 79 79 79 79 79 79 79 90 2 2 269 95 98 95 96 270 2 2 2 2 51 56 0 97 97 97 97 84 79 79 79 79 79 79 79 79 90 2 2 2 2 2 41 6 40 257 84 79 79 90 0 -1 -1 -1 -1 -1 -1 -1 -1 -1 -1 -1 -1 -1 -1 -1 -1 -1 -1 -1 -1 -1
0 0 0 50 2 2 49 0 0 0 0 0 0 0 0 0 1 0 54 2 127 51 56 0 0 0 0 0 0 0 0 55 2 2 53 0 0 0 0 0 0 36 50 2 2 2 49 0 0 81 79 79 79 79 79 79 79 79 79 79 79 79 79 79 79 90 2 2 267 59 59 59 59 268 2 2 2 2 2 2 56 0 0 97 97 81 83 83 83 83 83 83 83 83 82 2 2 2 2 2 44 45 43 2 84 79 79 90 0 0 0 0 0 0 -1 -1 -1 -1 -1 -1 -1 -1 -1 -1 -1 -1 -1 -1 -1 -1
0 0 0 50 2 2 49 0 0 1 0 0 0 0 0 0 0 0 0 54 52 2 2 51 56 0 24 25 22 0 55 2 2 53 0 0 3 0 1 0 3 0 50 2 2 2 49 1 95 58 81 83 83 83 83 83 83 83 83 83 83 83 83 83 83 82 2 2 2 2 2 2 2 2 2 52 52 2 2 2 2 56 0 0 0 0 0 0 0 0 0 50 2 2 2 2 2 2 2 2 28 4 27 2 84 79 79 90 0 0 0 0 0 0 0 -1 -1 -1 -1 -1 -1 -1 -1 -1 -1 -1 -1 -1 -1 -1
0 0 0 50 2 2 49 0 0 0 0 0 0 1 0 0 0 1 0 0 1 54 2 2 2 51 51 51 51 51 2 2 53 0 0 0 0 0 0 9 0 22 50 2 2 2 49 0 3 58 58 58 58 58 58 58 58 58 58 58 58 58 58 58 58 2 2 52 52 52 52 52 52 52 53 0 0 54 52 2 2 2 56 0 47 0 0 124 55 51 51 2 2 2 2 2 2 2 2 2 27 27 27 2 84 79 79 90 0 0 0 0 0 0 0 -1 -1 -1 -1 -1 -1 -1 -1 -1 -1 -1 -1 -1 -1 -1
0 0 0 50 2 2 49 0 0 0 0 0 0 0 0 1 0 0 0 38 0 0 2 2 2 2 2 2 2 2 2 53 0 0 0 0 1 0 8 6 7 1 50 2 2 2 49 1 97 58 39 39 58 39 39 39 39 58 39 39 58 32 32 32 58 2 49 47 0 1 0 0 1 0 0 0 1 1 0 54 2 2 2 56 48 0 55 51 2 2 2 2 52 52 2 2 2 2 2 2 2 2 2 2 84 79 79 90 0 0 0 0 0 0 0 0 0 0 0 0 0 0 0 0 0 0 -1 -1 -1 -1
0 0 0 50 2 2 49 0 0 0 0 0 0 0 0 0 0 0 0 37 1 55 2 2 2 2 2 2 2 2 49 0 0 0 0 0 0 273 11 5 10 1 50 2 2 2 49 1 96 58 34 34 58 39 39 39 39 58 39 39 58 32 32 32 58 2 49 48 0 0 0 0 0 0 0 0 1 1 1 0 54 2 2 2 51 51 2 2 2 2 2 53 0 0 54 52 52 52 52 52 2 2 2 2 84 79 79 90 0 0 0 0 0 0 0 0 0 0 0 0 0 0 0 0 0 0 -1 -1 -1 -1
0 0 0 50 2 2 49 0 0 0 0 1 0 0 3 1 1 1 0 36 55 2 2 2 52 52 2 2 2 2 49 0 0 1 0 1 0 272 0 4 0 0 50 2 2 2 49 38 3 58 34 34 58 34 34 34 34 58 34 34 58 32 32 32 58 2 49 0 0 0 0 0 0 0 0 0 1 1 0 0 0 54 2 2 2 2 2 2 2 2 53 0 1 1 1 0 0 0 97 97 54 2 2 2 84 79 79 90 0 0 0 0 0 0 0 0 0 0 0 0 0 0 0 0 0 0 -1 -1 -1 -1
0 0 0 50 2 2 49 0 0 0 1 1 1 0 22 0 1 0 0 55 2 2 2 49 0 97 54 2 2 2 49 0 0 1 1 0 0 36 0 3 0 3 50 2 2 2 49 37 95 58 34 34 58 34 34 34 34 58 34 34 58 32 32 32 58 2 49 0 1 0 0 0 0 0 0 0 0 0 0 0 0 124 54 2 2 2 2 2 2 53 0 0 0 1 0 0 1 0 0 0 97 91 83 83 83 83 83 83 79 0 0 0 0 0 0 0 0 0 0 0 0 0 0 0 0 0 0 -1 -1 -1
0 0 0 50 2 2 49 0 0 0 0 0 0 0 0 0 0 0 55 2 2 2 2 53 0 0 0 54 2 2 2 56 0 0 0 0 0 0 0 0 0 0 50 2 2 2 49 36 98 58 277 34 58 34 34 34 34 58 34 34 58 58 58 58 58 52 53 0 0 1 0 0 0 0 0 0 0 0 1 0 0 0 0 54 2 2 2 2 49 0 0 0 0 0 0 1 1 0 0 1 95 84 79 79 79 79 79 79 90 0 0 0 0 0 0 0 0 0 0 0 0 0 0 0 0 0 0 -1 -1 -1
0 0 0 50 2 2 49 0 0 0 0 0 0 0 0 0 0 55 2 2 2 2 53 0 0 0 0 0 54 2 2 2 56 97 0 0 0 0 0 0 0 0 50 2 2 2 49 1 9 3 276 275 58 34 34 34 34 58 34 32 58 0 0 0 1 0 0 0 0 0 0 0 0 0 0 0 0 0 0 0 0 0 0 0 54 2 2 2 53 0 0 0 0 0 0 1 0 0 0 0 96 84 84 79 79 79 79 79 90 0 0 0 0 0 0 0 0 0 0 0 0 0 0 0 0 0 -1 -1 -1 -1
0 0 0 50 2 2 49 0 0 0 0 0 0 0 0 0 55 2 2 2 2 53 0 0 0 0 0 0 0 54 2 2 2 56 1 1 1 1 0 0 0 0 50 2 2 2 49 8 6 7 97 274 58 34 34 34 34 58 32 3 0 1 9 0 0 0 0 0 0 0 0 0 0 0 0 0 0 0 0 0 0 0 0 0 0 50 2 49 0 0 0 1 0 0 0 1 0 1 1 0 95 84 84 79 79 79 79 90 90 0 0 0 0 0 0 0 0 0 0 0 0 0 0 0 0 0 -1 -1 -1 -1
0 0 0 50 2 2 49 0 0 0 0 0 0 0 0 55 2 2 2 2 53 0 0 0 0 0 0 0 0 0 50 2 2 2 56 0 1 1 1 0 0 0 50 2 2 2 49 11 5 10 1 3 58 32 32 32 32 58 98 0 0 8 6 7 0 0 0 0 0 0 0 0 0 0 0 0 0 0 0 0 0 0 0 0 0 50 2 49 0 0 1 1 1 1 1 1 0 1 1 0 95 84 84 79 79 79 79 90 90 0 0 0 0 0 0 0 0 0 0 0 0 0 0 0 0 0 -1 -1 -1 -1
0 0 0 50 2 2 49 0 0 0 0 0 0 0 55 2 2 2 2 53 0 0 0 0 0 0 0 0 0 0 54 2 2 2 2 56 0 0 0 0 9 26 50 2 2 2 49 0 4 0 1 0 0 0 31 0 0 0 0 22 3 11 5 10 1 0 1 0 1 0 0 0 0 0 0 0 0 0 0 0 0 0 0 0 0 50 2 49 0 0 1 0 1 1 1 1 0 1 1 0 1 84 84 79 79 79 79 90 90 0 0 0 0 0 0 0 0 0 0 0 0 0 0 0 0 0 -1 -1 -1 -1
0 0 0 50 2 2 49 0 0 0 0 0 0 55 2 2 2 2 53 1 0 1 0 0 1 0 0 1 0 0 0 54 2 2 2 2 56 0 1 8 6 7 50 2 2 2 49 0 3 27 0 0 9 0 0 1 0 27 0 0 0 0 4 1 0 0 0 0 0 0 0 0 0 0 0 1 0 0 0 0 0 0 0 0 0 50 2 49 0 0 1 0 1 0 0 1 0 0 1 0 96 84 84 79 79 79 79 90 90 0 0 0 0 0 0 0 0 0 0 0 0 0 0 0 0 0 -1 -1 150 150
0 0 0 50 2 127 49 0 0 0 0 0 55 2 2 2 2 53 0 0 0 0 0 0 0 0 0 0 0 0 0 0 54 2 2 2 2 56 0 11 5 10 50 2 2 2 49 1 57 23 28 8 6 7 0 57 0 23 0 28 0 0 0 0 0 27 0 0 0 0 0 0 9 0 0 0 0 0 0 0 0 0 0 9 0 50 2 49 0 0 1 0 1 0 0 1 1 0 0 1 95 84 84 79 79 79 79 90 90 0 0 0 0 0 0 0 0 0 0 0 0 0 0 0 0 0 0 0 150 150
0 0 0 50 2 2 49 0 0 0 0 55 2 2 2 2 53 0 0 0 0 0 0 0 0 1 0 0 1 0 0 0 0 54 2 2 2 2 56 0 4 0 50 2 2 2 49 0 273 0 3 11 5 10 0 0 273 0 27 0 0 0 3 57 0 23 28 0 1 273 0 8 6 7 0 0 0 0 0 0 0 0 8 6 7 50 2 49 0 0 1 1 1 0 0 0 0 0 0 1 96 84 84 79 79 79 79 90 90 0 0 0 0 0 0 0 0 0 0 0 0 0 0 0 0 0 0 0 150 150
56 0 0 50 2 2 49 0 0 0 55 2 2 2 2 53 0 0 0 0 1 0 3 0 0 1 0 0 0 0 0 0 1 0 54 2 2 2 2 56 0 0 50 2 2 2 49 3 272 0 27 0 4 0 1 0 272 0 1 0 0 0 1 0 27 0 0 0 0 272 0 11 5 10 0 47 0 0 0 0 0 0 11 5 10 50 2 49 0 0 1 1 0 0 0 0 0 0 0 0 95 84 84 79 79 79 79 90 90 0 0 0 0 0 0 0 0 0 0 0 0 0 0 0 0 0 0 0 150 150
2 56 0 50 2 2 49 0 0 55 2 2 2 2 49 22 0 0 0 0 0 0 0 0 1 0 0 0 0 0 24 25 0 0 0 50 2 2 2 2 56 1 50 2 2 2 49 22 36 0 0 0 3 0 0 0 36 0 0 258 259 1 1 0 3 1 0 1 0 36 24 25 4 1 0 48 0 24 25 0 0 0 0 4 0 50 2 49 124 0 1 0 0 0 0 0 0 0 0 0 22 84 84 79 79 79 79 90 90 124 124 124 124 124 124 124 124 124 124 124 124 124 124 124 124 124 124 124 124 124
2 2 51 2 2 2 2 51 51 2 2 2 2 2 2 51 51 51 51 51 51 51 51 51 51 51 51 51 51 51 51 51 51 51 51 2 2 2 2 2 2 51 2 2 2 2 2 51 51 51 51 51 51 51 51 51 51 51 51 51 51 51 51 51 51 51 51 51 51 51 51 51 51 51 51 51 51 51 51 51 51 51 51 51 51 2 2 2 51 51 51 51 51 51 51 51 51 51 51 51 51 84 84 79 79 79 79 90 90 0 0 0 0 0 0 0 0 1 0 0 0 0 0 0 0 0 0 0 150 150
2 2 2 2 2 2 2 2 2 2 2 2 2 2 2 2 2 2 2 2 2 2 2 2 2 2 2 2 2 2 2 2 2 2 2 2 2 2 2 2 2 2 2 2 2 2 2 2 2 2 2 2 2 2 2 2 2 2 2 2 2 2 42 2 2 2 2 2 2 2 2 2 2 2 2 2 42 2 2 2 2 2 2 2 2 2 2 2 2 2 2 2 2 2 2 2 2 2 2 2 2 84 84 79 79 79 79 90 90 0 0 0 0 0 0 3 0 1 0 0 0 0 0 1 1 0 0 0 150 150
2 2 2 2 2 2 2 2 2 2 2 2 2 2 2 2 2 2 2 2 2 2 2 2 2 2 2 2 2 2 2 2 2 2 2 2 2 2 2 2 2 2 2 2 2 2 2 2 2 2 2 2 2 2 2 2 2 2 2 2 2 41 6 40 2 2 2 2 2 2 2 2 2 2 2 41 6 40 2 2 2 2 2 2 2 2 2 2 2 2 2 2 2 2 2 2 2 2 2 2 2 84 84 79 79 79 79 90 90 0 3 0 0 0 0 1 1 1 1 1 1 1 0 3 1 0 0 0 150 150
2 2 52 2 2 2 2 52 52 52 52 52 52 52 52 52 52 52 52 52 52 52 52 52 52 52 52 52 52 52 52 52 52 52 52 52 52 52 52 52 52 52 52 2 2 2 2 2 2 52 52 52 52 52 52 52 52 52 52 52 52 44 45 43 52 52 52 52 52 52 52 52 52 52 52 44 45 43 52 52 52 52 52 52 52 52 52 52 52 52 52 52 52 52 52 52 52 52 2 2 2 84 84 79 79 79 79 90 90 0 0 0 0 0 1 1 1 1 1 1 1 1 0 0 0 0 0 0 150 150
2 53 0 50 2 2 49 0 258 259 0 0 0 0 0 0 258 259 0 0 0 0 0 0 3 0 0 0 0 0 0 258 259 0 0 0 0 0 0 3 0 0 9 54 2 2 2 2 49 0 0 3 0 0 0 0 258 259 1 0 0 1 4 0 0 0 258 259 0 0 0 0 0 0 0 0 4 0 0 0 0 0 0 0 0 0 0 0 0 0 0 1 1 0 0 0 24 25 50 2 2 84 84 79 79 79 79 90 90 0 0 0 9 0 0 0 3 0 0 1 1 3 0 0 0 0 0 0 150 150
53 0 0 50 2 2 49 0 0 0 0 0 0 0 0 0 0 0 0 0 0 0 0 0 0 0 0 0 0 0 0 0 0 0 0 0 0 0 0 0 0 8 6 7 54 2 2 2 2 56 0 0 1 0 0 0 0 0 3 0 0 0 0 0 0 0 0 1 0 0 0 0 0 0 1 0 0 0 0 0 0 0 0 0 0 0 0 0 0 0 1 1 1 0 0 0 0 0 50 2 2 84 84 79 79 79 79 90 90 0 0 8 6 7 0 0 0 0 0 0 1 9 0 0 0 0 0 0 150 150
0 0 0 50 2 2 49 0 0 0 0 0 0 0 0 0 0 0 0 0 0 0 0 0 0 0 0 0 0 0 0 0 0 0 0 0 0 0 0 1 1 11 5 10 3 54 2 2 2 2 56 0 1 1 1 3 0 0 0 1 0 0 0 1 0 0 0 0 0 1 0 0 0 0 0 0 0 0 0 0 0 0 0 0 0 0 0 1 0 1 0 0 1 0 0 0 0 0 50 2 2 84 84 79 79 79 79 90 90 0 0 11 5 10 1 0 0 0 1 0 8 6 7 150 151 152 152 153 150 150
0 0 0 50 2 2 49 0 0 0 0 0 0 0 0 0 0 0 0 0 0 0 0 0 0 0 0 0 0 0 0 0 0 0 0 0 0 0 1 1 3 0 4 0 0 1 54 2 2 2 49 0 9 0 1 1 0 1 3 0 0 0 0 0 0 0 0 0 0 0 0 0 1 0 0 0 0 0 0 0 0 0 0 0 0 0 1 1 1 0 0 0 1 0 0 0 0 0 50 2 2 84 84 79 79 79 79 90 90 0 0 0 4 0 0 3 0 9 0 0 11 5 10 150 156 155 155 154 150 150
0 0 0 50 2 2 49 0 0 0 0 0 0 0 0 0 0 0 0 0 0 0 0 0 0 0 0 0 0 0 0 0 0 0 0 0 0 0 1 1 1 0 0 0 0 0 22 50 2 2 49 8 6 7 0 0 0 0 0 1 0 0 1 1 1 0 0 0 0 0 0 0 0 0 0 0 0 0 0 0 0 0 0 0 0 1 1 0 0 0 0 0 1 0 0 0 0 0 50 2 2 84 84 79 79 79 79 90 90 0 3 0 0 0 0 0 8 6 7 1 1 4 31 55 51 51 51 56 150 150
0 0 0 50 2 2 49 0 0 0 0 0 0 0 0 0 0 0 0 0 0 0 0 0 0 0 0 0 0 0 0 0 0 0 0 0 0 0 0 0 0 1 1 0 0 3 0 50 2 127 49 11 5 10 0 1 0 0 0 0 0 0 1 1 0 1 0 0 0 0 0 0 0 0 0 0 0 0 0 0 0 0 0 0 0 1 1 1 0 1 1 0 1 1 1 1 0 0 50 2 2 84 84 79 79 79 79 90 90 0 0 0 0 0 3 1 11 5 10 0 55 51 51 2 2 2 2 53 150 150
0 0 0 50 2 2 49 0 0 0 0 0 0 0 0 0 0 0 0 0 0 0 0 0 0 0 0 0 0 0 0 0 0 0 0 0 0 0 0 0 0 0 1 0 0 9 1 50 2 2 49 0 4 0 1 0 0 0 1 0 1 1 1 1 0 0 0 0 0 0 0 0 0 0 0 0 0 0 0 0 0 0 0 0 0 1 0 0 0 0 1 1 0 0 0 0 0 0 50 2 2 84 84 79 79 79 79 90 90 0 0 9 0 38 1 1 0 4 55 51 2 2 2 2 42 2 53 0 150 150
0 0 0 50 2 2 49 0 0 0 0 0 0 0 0 0 0 0 0 0 0 0 0 0 0 0 0 0 0 0 0 0 0 0 0 0 0 0 0 0 0 0 0 0 8 6 7 50 2 2 49 0 0 0 0 0 0 0 0 0 0 0 0 1 0 0 1 0 0 0 0 0 0 0 0 0 0 0 0 0 0 0 0 0 0 0 0 0 0 0 0 0 0 1 0 0 0 0 50 2 2 84 84 79 79 79 79 90 90 0 8 6 7 37 1 1 0 55 2 2 2 2 2 41 6 40 3 0 150 150
0 0 0 50 2 2 49 0 0 0 0 0 0 0 0 0 0 0 0 0 0 0 3 0 0 0 0 0 0 0 0 0 1 0 0 0 0 0 0 0 0 0 0 3 11 5 10 50 2 2 49 31 1 0 0 0 0 1 0 0 0 0 0 0 0 0 0 0 0 0 0 0 0 0 0 0 1 0 0 0 0 0 0 0 9 0 0 0 0 0 1 0 0 0 0 0 0 0 50 2 2 84 84 79 83 83 79 90 90 0 11 5 10 36 55 51 2 42 2 127 2 2 52 44 5 10 0 0 150 150
0 0 0 50 2 2 49 0 0 0 0 0 0 0 0 0 0 0 0 0 0 0 0 0 0 0 0 0 0 3 0 0 0 0 0 38 0 0 1 0 0 0 0 0 0 4 0 50 2 2 49 0 0 0 38 0 0 0 0 1 0 3 1 38 0 0 0 0 0 0 0 0 0 0 0 0 0 0 0 0 0 0 0 8 6 7 0 1 0 0 0 1 0 0 0 0 0 0 50 2 2 81 83 82 58 58 81 83 82 0 0 4 55 51 2 2 41 6 40 2 2 53 0 0 4 0 0 0 150 150
0 0 0 50 2 2 49 0 0 0 0 0 0 0 0 0 0 0 0 0 0 0 0 3 0 0 0 0 1 1 1 1 1 0 0 37 3 1 1 0 3 0 0 1 1 0 0 50 2 2 49 0 0 0 37 0 0 0 0 1 1 1 1 37 0 3 0 47 0 0 0 0 0 0 1 0 0 1 0 0 0 0 0 11 5 10 0 0 0 0 1 1 0 0 1 0 0 0 50 2 2 96 33 100 39 39 101 33 0 0 0 55 2 2 2 2 44 45 43 52 53 0 1 0 0 0 0 0 150 150
0 0 0 50 2 2 49 22 24 25 0 0 258 259 0 0 0 0 0 0 0 22 0 0 0 258 259 0 0 0 1 1 1 0 0 36 0 1 0 0 24 25 0 1 1 3 0 50 2 2 49 124 0 0 36 0 0 0 258 259 31 0 0 36 0 0 0 48 0 0 0 0 0 0 0 0 0 0 0 0 0 0 0 1 4 0 1 0 0 0 0 0 0 1 0 0 0 124 50 2 2 95 32 100 67 67 101 32 96 55 2 42 2 2 52 52 53 4 0 0 0 0 1 0 0 0 0 0 150 150
0 0 0 50 2 2 2 51 51 51 51 51 51 51 51 51 51 51 51 51 51 51 51 51 51 51 51 51 51 51 51 51 51 51 51 51 51 51 51 51 51 51 51 51 51 51 51 2 2 2 2 51 51 51 51 51 51 51 51 51 51 51 51 51 51 51 51 51 51 51 51 51 51 51 51 51 51 51 51 51 51 51 51 51 51 51 51 51 51 51 51 51 51 51 51 51 51 51 2 2 2 2 2 2 2 2 2 2 2 2 41 6 40 53 0 0 38 0 1 1 1 3 1 1 0 0 3 0 150 150
0 0 0 50 2 2 2 2 2 2 2 2 2 2 2 2 2 2 2 2 2 2 2 2 2 2 2 2 2 2 2 2 2 2 2 2 2 2 2 2 2 2 2 2 2 2 2 2 2 2 2 2 2 2 2 2 2 2 2 2 2 2 2 2 2 2 2 2 2 2 2 2 2 2 2 2 2 2 2 42 2 2 2 2 2 2 2 42 2 2 2 2 2 42 2 2 2 2 2 2 2 2 2 2 2 2 2 2 2 2 44 45 43 0 1 1 37 0 1 1 1 1 1 1 0 0 0 0 150 150
0 0 0 50 2 2 2 2 2 127 2 2 2 2 2 2 2 2 2 2 2 2 2 2 2 2 2 2 2 2 2 2 2 2 2 2 2 2 2 2 2 2 2 2 2 2 2 2 2 2 2 127 2 2 2 2 2 2 2 2 2 2 2 2 2 2 2 2 2 2 2 2 2 2 2 2 2 2 41 6 40 2 2 2 2 2 41 6 40 2 2 2 41 6 40 2 2 2 2 2 2 2 2 2 2 52 52 52 52 53 0 4 0 0 3 1 36 1 1 1 1 1 1 1 0 0 0 0 150 150
0 0 0 54 52 52 52 52 52 52 52 52 52 52 52 52 52 52 52 52 52 52 52 52 52 52 52 52 52 52 52 52 52 52 52 52 52 52 52 52 52 52 52 52 52 52 52 52 52 52 52 52 52 52 52 52 52 52 52 52 52 52 52 52 52 52 52 52 52 52 52 52 52 52 52 52 52 52 44 45 43 52 52 52 52 52 44 45 43 52 52 52 44 45 43 52 52 52 2 2 2 2 52 52 53 0 0 1 1 1 1 0 0 0 1 1 1 1 1 1 1 1 1 0 0 0 0 0 150 150
0 0 0 0 0 0 258 259 0 0 0 0 0 0 0 0 0 0 0 0 0 0 0 0 0 0 0 0 1 1 1 1 258 259 0 0 0 0 0 0 0 0 1 1 1 0 0 258 259 0 0 0 0 0 0 0 0 0 0 0 258 259 0 0 0 0 0 0 0 9 0 0 0 0 0 0 1 0 0 4 0 0 0 0 0 0 0 4 0 0 0 0 0 4 0 0 1 22 50 2 2 49 47 1 0 3 0 0 1 1 0 0 1 0 0 0 0 0 0 0 1 1 0 0 0 0 0 0 150 150
0 0 0 0 0 0 0 0 0 0 0 0 0 0 0 0 0 0 0 0 0 0 0 0 0 0 0 0 1 1 1 1 0 0 0 0 0 0 0 0 0 0 0 0 0 0 0 0 0 0 0 0 0 0 0 0 0 0 0 0 0 0 0 0 0 0 0 0 8 6 7 0 0 0 0 1 0 0 0 0 0 0 0 0 1 0 0 0 0 0 27 27 0 0 1 1 1 1 50 2 2 49 48 0 1 1 0 1 1 1 3 0 1 0 0 0 3 0 0 0 0 0 0 0 3 0 0 0 150 150
0 0 0 0 0 0 0 0 0 0 0 0 0 0 0 0 0 0 0 0 0 0 0 0 0 0 0 0 0 0 1 0 0 0 0 0 0 0 0 0 0 0 0 0 0 0 0 0 0 0 0 0 0 0 0 0 0 0 0 0 0 0 0 0 0 0 0 0 11 5 10 1 0 0 0 0 0 0 0 0 0 0 0 0 0 0 0 1 0 0 0 9 0 0 0 0 1 1 50 2 2 49 1 1 1 0 0 1 1 1 0 0 1 0 0 0 0 0 0 0 0 0 0 0 0 0 0 0 150 150
0 0 0 0 0 0 0 0 0 0 0 0 0 0 0 0 0 0 0 0 0 0 0 0 0 1 0 0 0 0 0 0 0 0 0 0 0 0 0 0 0 0 0 0 0 0 0 0 0 0 0 0 0 0 0 0 0 0 0 0 0 0 0 0 0 0 0 0 0 4 0 16 12 12 12 12 12 12 15 0 0 0 0 0 1 0 0 0 0 0 8 6 7 1 0 1 0 0 50 2 2 49 1 1 0 0 1 1 1 1 1 1 1 0 0 0 0 0 0 0 0 0 0 0 0 0 0 0 150 150
0 0 0 0 0 0 0 0 0 0 0 0 0 0 0 0 0 0 0 0 0 0 0 0 0 0 0 0 0 0 0 0 0 0 0 0 0 0 0 0 0 0 0 0 0 0 0 0 0 0 0 0 0 0 0 0 0 0 0 0 0 0 0 0 0 0 0 0 0 16 12 12 12 12 12 12 12 12 12 12 12 12 12 12 12 12 12 15 1 0 11 5 10 1 0 1 0 0 50 2 2 49 0 0 0 0 0 3 1 0 0 0 0 0 0 0 0 3 0 0 0 0 0 0 0 0 0 0 150 150
0 0 0 0 0 0 0 0 0 0 0 0 0 0 0 0 0 0 0 0 0 0 0 0 0 0 0 0 0 0 0 0 0 0 0 0 0 0 0 0 0 0 0 0 0 0 0 0 0 0 0 0 0 0 0 0 0 0 0 0 0 0 0 0 0 0 0 16 12 12 12 12 12 12 12 12 12 12 12 12 12 12 12 12 12 12 12 12 12 12 15 4 0 1 1 1 1 0 50 2 2 49 0 0 0 0 0 1 1 1 0 0 0 0 0 0 0 0 0 0 0 0 0 0 0 0 0 0 150 150
0 0 0 0 0 0 0 0 0 0 0 0 0 0 0 0 0 0 0 0 0 0 0 0 0 0 0 0 0 0 0 0 0 0 0 0 0 0 0 0 0 0 0 0 0 0 0 0 0 0 0 0 0 0 0 0 0 0 0 0 0 0 0 0 0 0 16 12 12 12 12 12 12 12 12 12 12 12 12 12 14 12 12 12 12 12 12 12 14 12 12 15 0 1 28 0 1 0 50 2 2 49 0 0 3 0 0 1 1 1 1 0 0 0 0 0 0 0 0 0 0 0 0 3 0 0 0 0 150 150
0 0 0 0 0 0 0 0 0 0 0 0 0 0 0 0 0 0 0 0 0 0 0 0 0 0 0 0 0 0 0 0 0 0 0 0 0 0 0 0 0 0 0 0 0 0 0 0 0 0 0 0 0 0 0 0 0 0 0 0 0 0 0 0 16 12 12 12 12 12 12 12 13 12 12 12 12 12 12 12 13 12 12 12 12 12 12 12 12 12 12 12 0 0 28 0 1 0 50 2 260 49 32 32 32 32 32 32 32 32 32 32 32 32 32 32 0 0 0 0 0 0 0 0 0 0 0 0 150 150
0 0 0 0 0 0 0 0 0 0 0 0 0 0 0 0 0 0 0 0 0 0 0 0 0 0 0 0 0 0 0 0 0 0 0 0 0 0 0 0 0 0 0 0 0 0 0 0 0 0 0 0 0 0 0 0 0 0 0 0 0 0 0 16 12 12 12 12 12 12 12 12 12 14 12 12 12 12 12 12 12 12 12 12 12 12 12 12 12 12 12 12 0 0 0 0 1 0 50 2 2 49 32 32 32 32 32 32 32 32 32 32 32 32 32 32 0 0 0 0 0 0 0 0 0 0 0 0 150 150
0 0 0 0 0 0 0 0 0 0 0 0 0 0 0 0 0 0 0 0 0 0 0 0 0 0 0 0 0 0 0 0 0 0 0 0 0 0 0 0 0 0 0 0 0 0 0 0 0 0 0 0 0 0 0 0 0 0 0 0 0 0 16 12 12 12 12 12 12 12 12 12 12 12 12 12 12 12 12 12 12 12 12 14 12 12 12 12 12 13 12 17 0 0 1 1 1 0 50 2 2 49 32 32 32 32 32 32 32 32 32 32 32 32 32 32 0 0 0 0 0 0 0 0 0 0 0 0 150 150