102 62
5 0 0 50 2 44 5 58 33 58 34 34 34 34 34 58 33 58 34 34 34 34 34 58 33 58 34 34 34 34 34 58 33 58 32 39 81 79 79 79 79 79 79 79 79 79 79 79 79 79 79 79 79 79 79 79 79 79 79 79 79 79 79 79 79 79 79 79 79 79 79 79 79 79 79 84 79 79 79 79 79 79 79 79 79 79 84 79 79 79 79 79 79 79 79 79 79 79 79 79 79 79
4 27 3 50 2 2 4 58 60 58 34 34 34 34 34 58 60 58 34 34 34 34 34 58 60 58 34 34 34 34 34 58 60 58 32 32 32 81 79 79 79 79 79 79 79 79 79 79 79 79 79 79 79 79 79 79 79 79 79 79 79 79 79 79 79 79 79 79 79 79 79 79 79 79 79 84 79 79 79 79 79 79 79 79 79 79 84 79 79 79 79 79 79 79 79 79 79 79 79 79 79 79
1 0 97 50 2 92 59 58 66 58 32 32 32 32 32 58 66 58 32 32 32 32 32 58 66 58 32 32 32 32 32 58 66 58 88 89 85 67 83 83 83 83 83 83 83 79 79 79 79 79 79 79 79 79 79 79 79 79 79 79 79 79 79 79 79 79 79 79 79 79 79 79 79 79 79 84 79 79 79 79 79 79 79 79 79 79 84 79 79 79 79 79 79 79 79 79 79 79 79 79 79 79
51 51 51 2 2 2 2 126 29 125 2 2 2 2 2 126 29 125 2 2 2 2 2 126 29 125 2 2 2 2 2 126 29 125 2 2 2 2 67 60 58 67 67 67 67 81 79 79 79 79 79 79 79 79 79 79 79 79 79 79 79 79 79 79 79 79 79 79 79 79 79 79 79 79 79 84 79 79 79 79 79 79 79 79 79 79 84 79 79 79 79 79 79 79 79 79 79 79 79 79 79 79
2 2 2 2 2 2 2 2 2 2 2 2 2 2 2 2 2 2 2 2 2 2 2 2 2 2 2 2 2 2 2 2 2 2 2 2 2 2 2 2 58 2 2 2 2 2 81 83 83 83 79 79 79 79 79 79 79 79 79 79 79 79 79 79 79 79 79 79 79 79 79 79 79 79 79 84 79 79 79 79 79 79 79 79 79 79 84 79 79 79 79 79 79 79 79 79 79 79 79 79 79 79
2 2 2 2 2 2 2 2 2 2 2 2 2 2 2 2 2 2 2 2 2 2 2 2 2 2 2 2 2 2 2 2 2 2 2 2 2 2 2 2 58 2 2 2 2 2 2 58 2 2 81 79 79 79 79 79 79 79 79 79 79 79 79 79 79 79 79 79 79 79 79 79 79 79 79 81 83 83 83 83 83 83 83 83 83 83 84 79 79 79 79 79 79 79 79 79 79 79 79 79 79 79
2 2 2 2 2 2 2 2 2 2 2 2 2 2 2 2 2 2 2 2 2 2 2 2 2 2 2 2 2 2 2 2 2 2 2 2 2 2 2 2 65 2 2 2 2 2 2 58 2 2 2 84 79 79 79 79 79 79 79 79 79 79 79 79 79 79 79 79 79 79 79 79 79 79 79 79 32 32 32 32 32 32 32 32 32 32 81 83 83 83 83 83 83 83 83 83 83 83 83 83 83 83
52 52 52 2 2 2 2 2 2 127 2 2 2 52 52 52 52 52 52 52 52 52 52 52 52 52 52 52 52 52 52 52 52 52 52 52 52 52 52 2 64 2 2 2 2 2 85 58 2 2 2 84 79 79 79 79 79 79 79 79 79 79 79 79 79 79 79 83 83 83 83 83 83 83 83 83 32 32 32 39 39 32 32 39 39 32 32 32 32 32 32 32 32 32 32 32 32 32 32 32 32 32
1 22 0 50 2 2 2 2 2 2 2 2 49 0 3 0 0 0 0 0 0 0 1 0 0 0 0 0 0 0 0 0 0 0 0 1 0 0 0 2 63 2 2 2 2 2 2 2 2 86 2 84 79 79 79 79 79 79 79 79 79 79 79 79 79 79 82 99 102 32 32 39 39 39 39 60 32 32 32 122 122 32 32 122 122 32 32 32 32 32 32 32 32 32 32 32 32 32 32 32 32 32
1 0 38 50 2 2 2 52 52 2 2 2 2 56 0 0 1 0 0 0 0 0 0 0 0 3 0 0 0 3 0 0 0 0 0 0 0 55 51 2 63 2 2 2 2 2 2 2 2 87 2 84 79 79 79 79 79 79 79 79 79 79 79 79 79 90 2 100 101 32 66 60 60 66 60 60 32 32 32 39 39 32 32 39 39 32 32 32 32 32 32 32 32 32 32 32 32 32 32 32 32 32
0 3 37 50 2 2 49 3 97 54 52 2 2 2 51 56 0 0 0 0 0 0 0 0 0 0 0 0 0 0 0 0 0 0 0 0 55 2 2 52 62 92 59 59 93 2 2 2 2 2 2 84 79 79 79 79 79 79 79 79 79 79 79 79 79 90 2 2 2 126 29 125 126 29 125 2 32 32 32 122 122 32 32 122 122 32 32 32 32 32 32 32 32 32 32 32 32 32 32 32 32 32
0 0 36 50 2 2 49 0 0 3 0 54 52 2 2 2 51 56 0 3 0 0 0 0 0 0 1 0 0 0 38 0 3 0 0 55 2 2 53 1 61 0 50 2 2 2 2 52 52 52 91 79 79 79 79 79 79 79 79 79 79 79 79 79 79 90 2 2 2 2 2 2 2 2 2 2 32 32 32 32 32 32 32 32 32 32 32 32 32 32 32 32 32 32 32 32 32 32 32 32 32 32
1 0 0 50 2 2 49 38 0 0 0 0 0 54 2 2 2 2 56 0 0 0 0 1 0 0 0 3 0 0 37 0 0 0 55 2 2 53 0 0 61 0 50 2 2 2 49 31 3 3 84 79 79 79 79 79 79 79 79 79 79 79 79 79 79 90 2 2 2 2 2 2 2 2 2 2 2 49 1 0 0 0 0 0 0 0 0 0 0 0 0 0 0 0 0 0 0 0 0 0 0 0
1 0 0 50 2 2 49 37 0 0 0 0 0 0 54 52 2 2 2 56 0 0 0 0 0 0 0 0 0 0 36 0 0 55 2 2 53 0 0 0 3 38 50 2 2 2 49 0 0 97 84 79 79 79 79 79 79 79 79 79 79 79 79 79 79 90 2 2 2 2 2 2 2 2 2 2 2 49 1 0 0 0 0 0 0 0 0 0 0 0 0 0 0 0 0 0 0 0 0 0 0 0
0 0 0 50 2 2 49 36 0 0 0 1 0 0 1 0 54 52 2 2 56 0 0 0 0 1 0 0 0 0 0 0 55 2 2 53 0 1 0 0 0 37 50 2 2 2 49 0 0 91 79 79 79 79 79 79 79 79 79 79 79 79 79 79 79 90 2 2 2 2 2 2 2 2 2 2 2 2 51 56 0 0 0 0 0 0 0 0 0 0 0 0 0 0 0 0 0 0 0 0 0 0
0 0 0 50 2 2 49 0 0 0 0 0 0 0 0 0 1 0 54 2 127 51 56 0 0 0 0 0 0 0 0 55 2 2 53 0 0 0 0 0 0 36 50 2 2 2 49 0 0 81 79 79 79 79 79 79 79 79 79 79 79 79 79 79 79 90 2 2 2 2 2 2 2 2 2 2 2 2 2 2 56 0 0 0 0 0 0 0 0 0 0 0 0 0 0 0 0 0 0 0 0 0
0 0 0 50 2 2 49 0 0 1 0 0 0 0 0 0 0 0 0 54 52 2 2 51 56 0 24 25 22 0 55 2 2 53 0 0 3 0 1 0 3 0 50 2 2 2 49 1 95 58 81 83 83 83 83 83 83 83 83 83 83 83 83 83 83 82 2 2 2 2 2 2 2 2 2 52 52 2 2 2 2 56 0 0 0 0 0 0 0 0 0 0 0 0 0 0 0 0 0 0 0 0
0 0 0 50 2 2 49 0 0 0 0 0 0 1 0 0 0 1 0 0 1 54 2 2 2 51 51 51 51 51 2 2 53 0 0 0 0 0 0 9 0 22 50 2 2 2 49 0 3 58 39 39 58 58 58 58 58 58 58 58 58 32 32 32 32 2 2 52 52 52 52 52 52 52 53 0 0 54 52 2 2 2 56 0 0 0 0 0 0 0 0 0 0 0 0 0 0 0 0 0 0 0
0 0 0 50 2 2 49 0 0 0 0 0 0 0 0 1 0 0 0 38 0 0 2 2 2 2 2 2 2 2 2 53 0 0 0 0 1 0 8 6 7 1 50 2 2 2 49 1 97 58 39 39 58 39 39 39 39 58 39 39 58 32 32 32 32 2 2 0 0 1 0 0 1 0 0 0 1 1 0 54 2 2 2 56 0 0 0 0 0 0 0 0 0 0 0 0 0 0 0 0 0 0
0 0 0 50 2 2 49 0 0 0 0 0 0 0 0 0 0 0 0 37 1 55 2 2 2 2 2 2 2 2 49 0 0 0 0 0 0 38 11 5 10 1 50 2 2 2 49 1 96 58 34 34 58 39 39 39 39 58 39 39 58 32 32 32 32 2 2 0 0 0 0 0 0 0 0 0 1 1 1 0 54 2 2 2 56 0 0 0 0 0 0 0 0 0 0 0 0 0 0 0 0 0
0 0 0 50 2 2 49 0 0 0 0 1 0 0 3 1 1 1 0 36 55 2 2 2 52 52 2 2 2 2 49 0 0 1 0 1 0 37 0 4 0 0 50 2 2 2 49 38 3 58 34 34 58 34 34 34 34 58 34 34 58 32 32 32 32 2 2 0 0 0 0 0 0 0 0 0 1 1 0 0 0 54 2 2 2 56 0 0 0 0 0 0 0 0 0 0 0 0 0 0 0 0
0 0 0 50 2 2 49 0 0 0 1 1 1 0 22 0 1 0 0 55 2 2 2 49 0 97 54 2 2 2 49 0 0 1 1 0 0 36 0 3 0 3 50 2 2 2 49 37 95 58 34 34 58 34 34 34 34 58 34 34 58 32 32 32 32 2 2 0 1 0 0 0 0 0 0 0 0 0 0 0 0 0 54 2 2 2 56 0 0 0 0 0 0 0 0 0 0 0 0 0 0 0
0 0 0 50 2 2 49 0 0 0 0 0 0 0 0 0 0 0 55 2 2 2 2 53 0 0 0 54 2 2 2 56 0 0 0 0 0 0 0 0 0 0 50 2 2 2 49 36 98 58 32 34 58 34 34 34 34 58 34 34 58 32 32 32 32 2 2 0 0 1 0 0 0 0 0 0 0 0 1 0 0 0 0 54 2 2 2 56 0 0 0 0 0 0 0 0 0 0 0 1 0 0
0 0 0 50 2 2 49 0 0 0 0 0 0 0 0 0 0 55 2 2 2 2 53 0 0 0 0 0 54 2 2 2 56 97 0 0 0 0 0 0 0 0 50 2 2 2 49 1 9 3 32 32 58 34 34 34 34 58 34 32 58 0 0 0 1 0 0 0 0 0 0 0 0 0 0 0 0 0 0 0 0 0 0 0 54 2 2 49 0 0 0 0 0 0 0 0 0 0 0 0 0 0
0 0 0 50 2 2 49 0 0 0 0 0 0 0 0 0 55 2 2 2 2 53 0 0 0 0 0 0 0 54 2 2 2 56 1 1 1 1 0 0 0 0 50 2 2 2 49 8 6 7 97 32 58 34 34 34 34 58 32 3 0 1 9 0 0 0 0 0 0 0 0 0 0 0 0 0 0 0 0 0 0 0 0 0 0 50 2 49 0 0 0 0 0 0 0 0 0 0 0 0 0 0
0 0 0 50 2 2 49 0 0 0 0 0 0 0 0 55 2 2 2 2 53 0 0 0 0 0 0 0 0 0 50 2 2 2 56 0 1 1 1 0 0 0 50 2 2 2 49 11 5 10 1 3 58 32 32 32 32 58 98 0 0 8 6 7 0 0 0 0 0 0 0 0 0 0 0 0 0 0 0 0 0 0 0 0 0 50 2 49 0 0 0 0 0 0 0 0 0 0 0 0 0 0
0 0 0 50 2 2 49 0 0 0 0 0 0 0 55 2 2 2 2 53 0 0 0 0 0 0 0 0 0 0 54 2 -1 2 2 56 0 0 0 0 9 26 50 2 2 2 49 0 4 0 1 0 0 0 31 0 0 0 0 22 3 11 5 10 1 0 1 0 1 0 0 0 0 0 0 0 0 0 0 0 0 0 0 0 0 50 2 49 0 0 0 0 0 0 0 0 0 0 0 0 0 0
0 0 0 50 2 2 49 0 0 0 0 0 0 55 2 2 2 2 53 1 0 1 0 0 1 0 0 1 0 0 0 54 2 2 2 2 56 0 1 8 6 7 50 2 2 2 49 0 3 27 0 0 9 0 0 1 0 27 0 0 0 0 4 1 0 0 0 0 0 0 0 0 0 0 0 1 0 0 0 0 0 0 0 0 0 50 2 49 0 0 0 0 0 0 0 0 0 0 0 0 0 0
0 0 0 50 2 127 49 0 0 0 0 0 55 2 2 2 2 53 0 0 0 0 0 0 0 0 0 0 0 0 0 0 54 2 2 2 2 56 0 11 5 10 50 2 2 2 49 1 57 23 28 8 6 7 0 57 0 23 0 28 0 0 0 0 0 27 0 0 0 0 0 0 9 0 0 0 0 0 0 0 0 0 0 9 0 50 2 49 0 0 0 0 0 0 0 0 0 0 0 0 0 0
0 0 0 50 2 2 49 0 0 0 0 55 2 2 2 2 53 0 0 0 0 0 0 0 0 1 0 0 1 0 0 0 0 54 2 2 2 2 56 0 4 0 50 2 2 2 49 0 38 0 3 11 5 10 0 0 38 0 27 0 0 0 3 57 0 23 28 0 1 38 0 8 6 7 0 0 0 0 0 0 0 0 8 6 7 50 2 49 0 0 0 0 0 0 0 0 0 0 0 0 0 0
0 0 0 50 2 2 49 0 0 0 55 2 2 2 2 53 0 0 0 0 1 0 3 0 0 1 0 0 0 0 0 0 1 0 54 2 2 2 2 56 0 0 50 2 2 2 49 3 37 0 27 0 4 0 1 0 37 0 1 0 0 0 1 0 27 0 0 0 0 37 0 11 5 10 0 47 0 0 0 0 0 0 11 5 10 50 2 49 0 0 0 0 0 0 0 0 0 0 0 0 0 0
0 0 0 50 2 2 49 0 0 55 2 2 2 2 49 22 0 0 0 0 0 0 0 0 1 0 0 0 0 0 24 25 0 0 0 50 2 2 2 2 56 1 50 2 2 2 49 22 36 0 0 0 3 0 0 0 36 0 0 20 21 1 1 0 3 1 0 1 0 36 24 25 4 1 0 48 0 24 25 0 0 0 0 4 0 50 2 49 0 0 0 0 0 0 0 0 0 0 0 0 0 0
0 0 0 50 2 2 2 51 51 2 2 2 2 2 2 51 51 51 51 51 51 51 51 51 51 51 51 51 51 51 51 51 51 51 51 2 2 2 2 2 2 51 2 2 2 2 2 51 51 51 51 51 51 51 51 51 51 51 51 51 51 51 51 51 51 51 51 51 51 51 51 51 51 51 51 51 51 51 51 51 51 51 51 51 51 2 2 2 51 51 51 51 51 51 51 51 51 51 51 51 51 56
0 0 0 50 2 2 2 2 2 2 2 2 2 2 2 2 2 2 2 2 2 2 2 2 2 2 2 2 2 2 2 2 2 2 2 2 2 2 2 2 2 2 2 2 2 2 2 2 2 2 2 2 2 2 2 2 2 2 2 2 2 2 42 2 2 2 2 2 2 2 2 2 2 2 2 2 42 2 2 2 2 2 2 2 2 2 2 2 2 2 2 2 2 2 2 2 2 2 2 2 2 2
0 0 0 50 2 2 2 2 2 2 2 2 2 2 2 2 2 2 2 2 2 2 2 2 2 2 2 2 2 2 2 2 2 2 2 2 2 2 2 2 2 2 2 2 2 2 2 2 2 2 2 2 2 2 2 2 2 2 2 2 2 41 6 40 2 2 2 2 2 2 2 2 2 2 2 41 6 40 2 2 2 2 2 2 2 2 2 2 2 2 2 2 2 2 2 2 2 2 2 2 2 2
0 0 0 50 2 2 2 52 52 52 52 52 52 52 52 52 52 52 52 52 52 52 52 52 52 52 52 52 52 52 52 52 52 52 52 52 52 52 52 52 52 52 52 2 2 2 2 2 2 52 52 52 52 52 52 52 52 52 52 52 52 44 45 43 52 52 52 52 52 52 52 52 52 52 52 44 45 43 52 52 52 52 52 52 52 52 52 52 52 52 52 52 52 52 52 52 52 52 2 2 2 2
0 0 0 50 2 2 49 0 20 21 0 0 0 0 0 0 20 21 0 0 0 0 0 0 3 0 0 0 0 0 0 20 21 0 0 0 0 0 0 3 0 0 9 54 2 2 2 2 49 0 0 3 0 0 0 0 20 21 1 0 0 1 4 0 0 0 20 21 0 0 0 0 0 0 0 0 4 0 0 0 0 0 0 0 0 0 0 0 0 0 0 0 0 0 0 0 0 0 50 2 2 2
0 0 0 50 2 2 49 0 0 0 0 0 0 0 0 0 0 0 0 0 0 0 0 0 0 0 0 0 0 0 0 0 0 0 0 0 0 0 0 0 0 8 6 7 54 2 2 2 2 56 0 0 1 0 0 0 0 0 3 0 0 0 0 0 0 0 0 1 0 0 0 0 0 0 1 0 0 0 0 0 0 0 0 0 0 0 0 0 0 0 0 0 0 0 0 0 0 0 50 2 2 2
0 0 0 50 2 2 49 0 0 0 0 0 0 0 0 0 0 0 0 0 0 0 0 0 0 0 0 0 0 0 0 0 0 0 0 0 0 0 0 1 1 11 5 10 3 54 2 2 2 2 56 0 1 1 1 3 0 0 0 1 0 0 0 1 0 0 0 0 0 1 0 0 0 0 0 0 0 0 0 0 0 0 0 0 0 0 0 0 0 0 0 0 0 0 0 0 0 0 50 2 2 2
0 0 0 50 2 2 49 0 0 0 0 0 0 0 0 0 0 0 0 0 0 0 0 0 0 0 0 0 0 0 0 0 0 0 0 0 0 0 1 1 3 0 4 0 0 1 54 2 2 2 49 0 9 0 1 1 0 1 3 0 0 0 0 0 0 0 0 0 0 0 0 0 1 0 0 0 0 0 0 0 0 0 0 0 0 0 0 0 0 0 0 0 0 0 0 0 0 0 50 2 2 2
0 0 0 50 2 2 49 0 0 0 0 0 0 0 0 0 0 0 0 0 0 0 0 0 0 0 0 0 0 0 0 0 0 0 0 0 0 0 1 1 1 0 0 0 0 0 22 50 2 2 49 8 6 7 0 0 0 0 0 1 0 0 0 1 0 0 0 0 0 0 0 0 0 0 0 0 0 0 0 0 0 0 0 0 0 0 0 0 0 0 0 0 0 0 0 0 0 0 50 2 2 2
0 0 0 50 2 2 49 0 0 0 0 0 0 0 0 0 0 0 0 0 0 0 0 0 0 0 0 0 0 0 0 0 0 0 0 0 0 0 0 0 0 1 1 0 0 3 0 50 2 127 49 11 5 10 0 1 0 0 0 0 0 0 0 0 0 0 0 0 0 0 0 0 0 0 0 0 0 0 0 0 0 0 0 0 0 0 0 0 0 0 0 0 0 0 0 0 0 0 50 2 2 2
0 0 0 50 2 2 49 0 0 0 0 0 0 0 0 0 0 0 0 0 0 0 0 0 0 0 0 0 0 0 0 0 0 0 0 0 0 0 0 0 0 0 1 0 0 9 1 50 2 2 49 0 4 0 1 0 0 0 1 0 1 0 0 0 0 0 0 0 0 0 0 0 0 0 0 0 0 0 0 0 0 0 0 0 0 0 0 0 0 0 0 0 0 0 0 0 0 0 50 2 2 2
0 0 0 50 2 2 49 0 0 0 0 0 0 0 0 0 0 0 0 0 0 0 0 0 0 0 0 0 0 0 0 0 0 0 0 0 0 0 0 0 0 0 0 0 8 6 7 50 2 2 49 0 0 0 0 0 0 0 0 0 0 0 0 1 0 0 1 0 0 0 0 0 0 0 0 0 0 0 0 0 0 0 0 0 0 0 0 0 0 0 0 0 0 0 0 0 0 0 50 2 2 2
0 0 0 50 2 2 49 0 0 0 0 0 0 0 0 0 0 0 0 0 0 0 3 0 0 0 0 0 0 0 0 0 1 0 0 0 0 0 0 0 0 0 0 3 11 5 10 50 2 2 49 31 1 0 0 0 0 1 0 0 0 0 0 0 0 0 0 0 0 0 0 0 0 0 0 0 0 0 0 0 0 0 0 0 0 0 0 0 0 0 0 0 0 0 0 0 0 0 50 2 2 2
0 0 0 50 2 2 49 0 0 0 0 0 0 0 0 0 0 0 0 0 0 0 0 0 0 0 0 0 0 3 0 0 0 0 0 38 0 0 1 0 0 0 0 0 0 4 0 50 2 2 49 0 0 0 38 0 0 0 0 1 0 3 1 38 0 0 0 0 0 0 0 0 0 0 0 0 0 0 0 0 0 0 0 0 0 0 0 0 0 0 0 0 0 0 0 0 0 0 50 2 2 2
0 0 0 50 2 2 49 0 0 0 0 0 0 0 0 0 0 0 0 0 0 0 0 3 0 0 0 0 1 1 1 1 1 0 0 37 3 1 1 0 3 0 0 1 1 0 0 50 2 2 49 0 0 0 37 0 0 0 0 1 1 1 1 37 0 3 0 47 0 0 0 0 0 0 0 0 0 0 0 0 0 0 0 0 0 0 0 0 0 0 0 0 0 0 0 0 0 0 50 2 2 2
0 0 0 50 2 2 49 22 24 25 0 0 20 21 0 0 0 0 0 0 0 22 0 0 0 20 21 0 0 0 1 1 1 0 0 36 0 1 0 0 24 25 0 1 1 3 0 50 2 2 49 124 0 0 36 0 0 0 20 21 31 0 0 36 0 0 0 48 0 0 0 0 0 0 0 0 0 0 0 0 0 0 0 0 0 0 0 0 0 0 0 0 0 0 0 0 0 0 50 2 2 2
0 0 0 50 2 2 2 51 51 51 51 51 51 51 51 51 51 51 51 51 51 51 51 51 51 51 51 51 51 51 51 51 51 51 51 51 51 51 51 51 51 51 51 51 51 51 51 2 2 2 2 51 51 51 51 51 51 51 51 51 51 51 51 51 51 51 51 51 51 51 51 51 51 51 51 51 51 51 51 51 51 51 51 51 51 51 51 51 51 51 51 51 51 51 51 51 51 51 2 2 2 2
0 0 0 50 2 2 2 2 2 2 2 2 2 2 2 2 2 2 2 2 2 2 2 2 2 2 2 2 2 2 2 2 2 2 2 2 2 2 2 2 2 2 2 2 2 2 2 2 2 2 2 2 2 2 2 2 2 2 2 2 2 2 2 2 2 2 2 2 2 2 2 2 2 2 2 2 2 2 2 2 2 2 2 2 2 2 2 2 2 2 2 2 2 2 2 2 2 2 2 2 2 2
0 0 0 50 2 2 2 2 2 127 2 2 2 2 2 2 2 2 2 2 2 2 2 2 2 2 2 2 2 2 2 2 2 2 2 2 2 2 2 2 2 2 2 2 2 2 2 2 2 2 2 127 2 2 2 2 2 2 2 2 2 2 2 2 2 2 2 2 2 2 2 2 2 2 2 2 2 2 2 2 2 2 2 2 2 2 2 2 2 2 2 2 2 2 2 2 2 2 2 2 2 2
0 0 0 54 52 52 52 52 52 52 52 52 52 52 52 52 52 52 52 52 52 52 52 52 52 52 52 52 52 52 52 52 52 52 52 52 52 52 52 52 52 52 52 52 52 52 52 52 52 52 52 52 52 52 52 52 52 52 52 52 52 52 52 52 52 52 52 52 52 52 52 52 52 52 52 52 52 52 52 52 52 52 52 52 52 52 52 52 52 52 52 52 52 52 52 52 52 52 2 2 2 2
0 0 0 0 0 0 20 21 0 0 0 0 0 0 0 0 0 0 0 0 0 0 0 0 0 0 0 0 1 1 1 1 20 21 0 0 0 0 0 0 0 0 1 1 1 0 0 20 21 0 0 0 0 0 0 0 0 0 0 0 20 21 0 0 0 0 0 0 0 0 0 0 0 0 0 0 0 0 0 0 0 0 0 0 0 0 0 0 0 0 0 0 0 0 0 0 0 0 50 2 2 2
0 0 0 0 0 0 0 0 0 0 0 0 0 0 0 0 0 0 0 0 0 0 0 0 0 0 0 0 1 1 1 1 0 0 0 0 0 0 0 0 0 0 0 0 0 0 0 0 0 0 0 0 0 0 0 0 0 0 0 0 0 0 0 0 0 0 0 0 0 0 0 0 0 0 0 0 0 0 0 0 0 0 0 0 0 0 0 0 0 0 0 0 0 0 0 0 0 0 50 2 2 2
0 0 0 0 0 0 0 0 0 0 0 0 0 0 0 0 0 0 0 0 0 0 0 0 0 0 0 0 0 0 1 0 0 0 0 0 0 0 0 0 0 0 0 0 0 0 0 0 0 0 0 0 0 0 0 0 0 0 0 0 0 0 0 0 0 0 0 0 0 0 0 0 0 0 0 0 0 0 0 0 0 0 0 0 0 0 0 0 0 0 0 0 0 0 0 0 0 0 50 2 2 2
0 0 0 0 0 0 0 0 0 0 0 0 0 0 0 0 0 0 0 0 0 0 0 0 0 1 0 0 0 0 0 0 0 0 0 0 0 0 0 0 0 0 0 0 0 0 0 0 0 0 0 0 0 0 0 0 0 0 0 0 0 0 0 0 0 0 0 0 0 0 0 0 0 0 0 0 0 0 0 0 0 0 0 0 0 0 0 0 0 0 0 0 0 0 0 0 0 0 50 2 2 2
0 0 0 0 0 0 0 0 0 0 0 0 0 0 0 0 0 0 0 0 0 0 0 0 0 0 0 0 0 0 0 0 0 0 0 0 0 0 0 0 0 0 0 0 0 0 0 0 0 0 0 0 0 0 0 0 0 0 0 0 0 0 0 0 0 0 0 0 0 0 0 0 0 0 0 0 0 0 0 0 0 0 0 0 0 0 0 0 0 0 0 0 0 0 0 0 0 0 50 2 2 2
0 0 0 0 0 0 0 0 0 0 0 0 0 0 0 0 0 0 0 0 0 0 0 0 0 0 0 0 0 0 0 0 0 0 0 0 0 0 0 0 0 0 0 0 0 0 0 0 0 0 12 12 12 12 12 12 12 12 0 0 0 0 0 0 0 0 0 0 0 0 0 0 0 0 0 0 0 0 0 0 0 0 0 0 0 0 0 0 0 0 0 0 0 0 0 0 0 0 50 2 2 2
0 0 0 0 0 0 0 0 0 0 0 0 0 0 0 0 0 0 0 0 0 0 0 0 0 0 0 0 0 0 0 0 0 0 12 12 12 12 12 12 12 12 12 12 12 12 12 12 12 12 12 12 12 12 12 12 12 12 0 0 0 0 0 0 0 0 0 0 0 0 0 0 0 0 0 0 0 0 0 0 0 0 0 0 0 0 0 0 0 0 0 0 0 0 0 0 0 0 50 2 2 2
0 0 0 0 0 0 0 0 0 0 0 0 0 0 0 0 0 0 0 0 0 0 0 0 0 0 0 0 0 0 0 0 0 0 12 12 12 12 12 12 12 12 12 12 12 12 12 12 12 12 12 12 12 12 12 12 12 12 0 0 0 0 0 0 0 0 0 0 0 0 0 0 0 0 0 0 0 0 0 0 0 0 0 0 0 0 0 0 0 0 0 0 0 0 0 0 0 0 50 2 31 2
0 0 0 0 0 0 0 0 0 0 0 0 0 0 0 0 0 0 0 0 0 0 0 0 0 0 0 0 0 0 0 0 0 0 12 12 12 12 12 12 12 12 12 12 12 12 12 12 12 12 12 12 12 12 12 12 12 0 0 0 0 0 0 0 0 0 0 0 0 0 0 0 0 0 0 0 0 0 0 0 0 0 0 0 0 0 0 0 0 0 0 0 0 0 0 0 0 0 50 2 2 2
0 0 0 0 0 0 0 0 0 0 0 0 0 0 0 0 0 0 0 0 0 0 0 0 0 0 0 0 0 0 0 0 0 0 12 12 12 12 12 12 12 12 12 12 12 12 12 12 12 12 12 12 12 12 12 12 12 12 0 0 0 0 0 0 0 0 0 0 0 0 0 0 0 0 0 0 0 0 0 0 0 0 0 0 0 0 0 0 0 0 0 0 0 0 0 0 0 0 50 2 2 2