17 12
8 6 7 0 0 0 0 0 0 0 0 0 0 0 0 0 0
11 5 10 0 0 0 0 0 0 0 0 0 0 0 0 0 0
0 4 0 0 3 0 0 3 0 0 3 3 0 0 3 0 0
0 3 0 0 0 0 3 3 3 0 3 3 3 0 0 0 0
0 0 0 0 0 3 3 3 3 3 3 3 3 3 0 0 0
0 0 0 0 0 3 3 3 3 3 3 3 3 3 0 3 0
0 0 0 0 0 0 3 3 3 3 3 3 3 0 0 9 0
0 3 0 0 0 0 0 3 3 3 3 3 0 0 8 6 7
0 0 0 0 3 0 0 0 3 3 3 0 0 0 11 5 10
0 0 0 0 0 0 0 0 0 3 0 0 0 0 3 4 0
0 3 0 0 0 0 3 3 0 0 0 0 0 0 0 0 0
0 0 0 0 0 0 0 0 0 0 0 0 0 0 0 0 0